#t 34 20 5 30
111111111111111111111111111
1 1                       1111111111111111111111111111111111111111111111111
1   22      22      22    1     1      1       1      1      1     1      1
1   22      22      22    1                                        1    2 1
1           22                                                     i      
111 11      2222                                                   1    2 1
1           22            1     1      1       1      1      1     1      1
1           22            111111111111111111111111111111111111111s11    2 1
1                         1             1                       1         1
1                         1             1                       1       2 1
1                         1             1                       1111s111111
1  s                                    1                          1 1
1                                       1                          1 1
1                         111111   111111                          1 1
1                         111111   1                               1 1
1    1 1 1                111111   1                               1 1
1                         111111   1                               1 1
1    1 2 1                111111   1           111111111111111111111 1
1                         1        1           1            11       1
1    1 1 1                1        1           1         2  11  111111
1                         1        1111111111111            11  1
1                         1        s                     q  g1  1
1                   1  iii1        1111111111111            11  1
1      x           1      1        1           1         2  11  1
1                 1       1i       1           1            11  1
11s11111111 111111111111111        1           111111111111111  1
          1 11   1   1 1111111111111                            1
          1 1  1 1 1 1 111                11                    1
          1   1    1     1                11   111111111111111111
11s111111111111111111111 1                     1              1
1                        1                     1    1         1
1                        1                     1111 11111111111
1                        1                          1
1                        1bbbbbbsbbbbbb111111111    1
11111  11111  1111111  111b           bq            1
1      1   1  1    g1  1bb            bq            1
1   1111   1  1    11  1bb            b11111111111111
1   1      1           1b             b
1   1                  1b  b      b   b
1   1                  1b             b
1   11111111111111111111b             b
1   1bbbbbbbbbbbbbbbbbbbbbbbbb   bbbbbb
1   1b                 b     b   b
1   1b                 bbbbbbb   b
1   1b                           b
1                      bbbbbbbbbbb
1   1b                 b
11111bbbbbbbb2bbbbbbbbbb
