111111111111111111111111111
1 1                       1
1   22  x   22      22    1
1   22      22      22    1
1           22            1
111 11      2222          1
1           22            1
1           22            111111111111111
1                         1             1
1                         1             1
1                         1             1
1                                       1
1                                       1
1                         111111   111111
1                         111111   1
1    1 1 1                111111   1
1    1 1 1                111111   1
1    1 1 1                1        1
1                         1        1
1                         1        1
1                         1        1
1                         1        1
1                         1        1
111111111111111111111111111        1
