11111111111111111111111111111111111111111111111111111111111111111111111111111111
1  x   1    1              1                      1                            1
1      1    1              0                      1                            1
1      1    1              1                      1        11           11     1
1      1    1              1                      1        11           11     1
111  111    111111101111111111111111111111101111111                            1
1                                  1                                           1
11111111    111111111111111111     1                       11           11     1
       1                     1                             11           11     1
	   1         1  1  1     0                                                 1
	   1                     1                                                 1
	   11111111111111111111111111111111111111111111111111111111        111111111
