000000x0000000
00000000000000
00001000100000
00000000000000
00001000100000
00000000000000
00001000100000
00000000000000
00001000100000
00000000000000
00001000100000
00000000000000
