111111
1    1
1 x  1
1    1111111111
1             1
1             1
111111111111111
